"filename", "language", "Java", "comment", "blank", "total"
"d:\eclipseWorkspace4\vmj-payment-gateway\modules\paymentgateway.apiauth.apikey\module-info.java", "Java", 10, 1, 3, 14
"d:\eclipseWorkspace4\vmj-payment-gateway\modules\paymentgateway.apiauth.apikey\paymentgateway\apiauth\apikey\model\APIKeyImpl.java", "Java", 32, 0, 11, 43
"d:\eclipseWorkspace4\vmj-payment-gateway\modules\paymentgateway.apiauth.apikey\paymentgateway\apiauth\apikey\resource\APIKeyResourceImpl.java", "Java", 11, 1, 4, 16
"d:\eclipseWorkspace4\vmj-payment-gateway\modules\paymentgateway.apiauth.basicauth\module-info.java", "Java", 10, 1, 3, 14
"d:\eclipseWorkspace4\vmj-payment-gateway\modules\paymentgateway.apiauth.basicauth\paymentgateway\apiauth\basicauth\model\basicAuthImpl.java", "Java", 36, 0, 16, 52
"d:\eclipseWorkspace4\vmj-payment-gateway\modules\paymentgateway.apiauth.basicauth\paymentgateway\apiauth\basicauth\resource\basicAuthResourceImpl.java", "Java", 12, 1, 6, 19
"d:\eclipseWorkspace4\vmj-payment-gateway\modules\paymentgateway.apiauth.core\module-info.java", "Java", 6, 5, 2, 13
"d:\eclipseWorkspace4\vmj-payment-gateway\modules\paymentgateway.apiauth.core\paymentgateway\apiauth\APIAuthFactory.java", "Java", 44, 0, 5, 49
"d:\eclipseWorkspace4\vmj-payment-gateway\modules\paymentgateway.apiauth.core\paymentgateway\apiauth\APIAuthResourceFactory.java", "Java", 47, 0, 8, 55
"d:\eclipseWorkspace4\vmj-payment-gateway\modules\paymentgateway.apiauth.core\paymentgateway\apiauth\core\model\APIAuth.java", "Java", 7, 0, 2, 9
"d:\eclipseWorkspace4\vmj-payment-gateway\modules\paymentgateway.apiauth.core\paymentgateway\apiauth\core\model\APIAuthComponent.java", "Java", 14, 0, 8, 22
"d:\eclipseWorkspace4\vmj-payment-gateway\modules\paymentgateway.apiauth.core\paymentgateway\apiauth\core\model\APIAuthDecorator.java", "Java", 15, 1, 8, 24
"d:\eclipseWorkspace4\vmj-payment-gateway\modules\paymentgateway.apiauth.core\paymentgateway\apiauth\core\model\APIAuthImpl.java", "Java", 16, 0, 6, 22
"d:\eclipseWorkspace4\vmj-payment-gateway\modules\paymentgateway.apiauth.core\paymentgateway\apiauth\core\resource\APIAuthResource.java", "Java", 4, 0, 2, 6
"d:\eclipseWorkspace4\vmj-payment-gateway\modules\paymentgateway.apiauth.core\paymentgateway\apiauth\core\resource\APIAuthResourceComponent.java", "Java", 6, 0, 4, 10
"d:\eclipseWorkspace4\vmj-payment-gateway\modules\paymentgateway.apiauth.core\paymentgateway\apiauth\core\resource\APIAuthResourceDecorator.java", "Java", 8, 0, 3, 11
"d:\eclipseWorkspace4\vmj-payment-gateway\modules\paymentgateway.apiauth.core\paymentgateway\apiauth\core\resource\APIAuthResourceImpl.java", "Java", 8, 1, 3, 12
"d:\eclipseWorkspace4\vmj-payment-gateway\modules\paymentgateway.apiauth.oauth\module-info.java", "Java", 10, 1, 3, 14
"d:\eclipseWorkspace4\vmj-payment-gateway\modules\paymentgateway.apiauth.oauth\paymentgateway\apiauth\oauth\model\oAuthImpl.java", "Java", 32, 1, 10, 43
"d:\eclipseWorkspace4\vmj-payment-gateway\modules\paymentgateway.apiauth.oauth\paymentgateway\apiauth\oauth\resource\oAuthResourceImpl.java", "Java", 57, 8, 14, 79
"d:\eclipseWorkspace4\vmj-payment-gateway\modules\paymentgateway.apiauth.signature\module-info.java", "Java", 10, 1, 3, 14
"d:\eclipseWorkspace4\vmj-payment-gateway\modules\paymentgateway.apiauth.signature\paymentgateway\apiauth\signature\model\signatureImpl.java", "Java", 25, 1, 9, 35
"d:\eclipseWorkspace4\vmj-payment-gateway\modules\paymentgateway.apiauth.signature\paymentgateway\apiauth\signature\resource\signatureResourceImpl.java", "Java", 56, 8, 14, 78
"d:\eclipseWorkspace4\vmj-payment-gateway\modules\paymentgateway.client.brankas\module-info.java", "Java", 9, 1, 3, 13
"d:\eclipseWorkspace4\vmj-payment-gateway\modules\paymentgateway.client.brankas\paymentgateway\client\brankas\model\BrankasImpl.java", "Java", 79, 0, 17, 96
"d:\eclipseWorkspace4\vmj-payment-gateway\modules\paymentgateway.client.brankas\paymentgateway\client\brankas\resource\BrankasResourceImpl.java", "Java", 7, 0, 4, 11
"d:\eclipseWorkspace4\vmj-payment-gateway\modules\paymentgateway.client.brankas\paymentgateway\client\brankas\validatorObject\FundTransferRequest.java", "Java", 406, 0, 121, 527
"d:\eclipseWorkspace4\vmj-payment-gateway\modules\paymentgateway.client.brankas\paymentgateway\client\brankas\validatorObject\FundTransferResponse.java", "Java", 156, 0, 47, 203
"d:\eclipseWorkspace4\vmj-payment-gateway\modules\paymentgateway.client.core\module-info.java", "Java", 9, 1, 2, 12
"d:\eclipseWorkspace4\vmj-payment-gateway\modules\paymentgateway.client.core\paymentgateway\client\core\ClientFactory.java", "Java", 61, 0, 7, 68
"d:\eclipseWorkspace4\vmj-payment-gateway\modules\paymentgateway.client.core\paymentgateway\client\core\ClientResourceFactory.java", "Java", 61, 0, 7, 68
"d:\eclipseWorkspace4\vmj-payment-gateway\modules\paymentgateway.client.core\paymentgateway\client\core\model\Client.java", "Java", 7, 0, 2, 9
"d:\eclipseWorkspace4\vmj-payment-gateway\modules\paymentgateway.client.core\paymentgateway\client\core\model\ClientComponent.java", "Java", 8, 0, 5, 13
"d:\eclipseWorkspace4\vmj-payment-gateway\modules\paymentgateway.client.core\paymentgateway\client\core\model\ClientDecorator.java", "Java", 9, 1, 7, 17
"d:\eclipseWorkspace4\vmj-payment-gateway\modules\paymentgateway.client.core\paymentgateway\client\core\model\ClientImpl.java", "Java", 10, 1, 5, 16
"d:\eclipseWorkspace4\vmj-payment-gateway\modules\paymentgateway.client.core\paymentgateway\client\core\resource\ClientResource.java", "Java", 4, 0, 2, 6
"d:\eclipseWorkspace4\vmj-payment-gateway\modules\paymentgateway.client.core\paymentgateway\client\core\resource\ClientResourceComponent.java", "Java", 5, 1, 3, 9
"d:\eclipseWorkspace4\vmj-payment-gateway\modules\paymentgateway.client.core\paymentgateway\client\core\resource\ClientResourceDecorator.java", "Java", 3, 0, 2, 5
"d:\eclipseWorkspace4\vmj-payment-gateway\modules\paymentgateway.client.core\paymentgateway\client\core\resource\ClientResourceImpl.java", "Java", 6, 0, 3, 9
"d:\eclipseWorkspace4\vmj-payment-gateway\modules\paymentgateway.client.oy\module-info.java", "Java", 10, 1, 3, 14
"d:\eclipseWorkspace4\vmj-payment-gateway\modules\paymentgateway.client.oy\paymentgateway\client\oy\model\OyImpl.java", "Java", 61, 0, 12, 73
"d:\eclipseWorkspace4\vmj-payment-gateway\modules\paymentgateway.client.oy\paymentgateway\client\oy\resource\OyResourceImpl.java", "Java", 7, 1, 3, 11
"d:\eclipseWorkspace4\vmj-payment-gateway\modules\paymentgateway.client.oy\paymentgateway\client\oy\validatorObject\FundTransferRequest.java", "Java", 52, 0, 15, 67
"d:\eclipseWorkspace4\vmj-payment-gateway\modules\paymentgateway.client.oy\paymentgateway\client\oy\validatorObject\FundTransferResponse.java", "Java", 68, 0, 20, 88
"d:\eclipseWorkspace4\vmj-payment-gateway\modules\paymentgateway.client.xendit\module-info.java", "Java", 10, 1, 3, 14
"d:\eclipseWorkspace4\vmj-payment-gateway\modules\paymentgateway.client.xendit\paymentgateway\client\xendit\model\XenditImpl.java", "Java", 83, 0, 24, 107
"d:\eclipseWorkspace4\vmj-payment-gateway\modules\paymentgateway.client.xendit\paymentgateway\client\xendit\resource\XenditResourceImpl.java", "Java", 7, 1, 3, 11
"d:\eclipseWorkspace4\vmj-payment-gateway\modules\paymentgateway.client.xendit\paymentgateway\client\xendit\validatorObject\FundTransferRequest.java", "Java", 82, 0, 4, 86
"d:\eclipseWorkspace4\vmj-payment-gateway\modules\paymentgateway.client.xendit\paymentgateway\client\xendit\validatorObject\FundTransferResponse.java", "Java", 45, 0, 3, 48
"d:\eclipseWorkspace4\vmj-payment-gateway\modules\paymentgateway.fundtransfer.core\module-info.java", "Java", 14, 1, 2, 17
"d:\eclipseWorkspace4\vmj-payment-gateway\modules\paymentgateway.fundtransfer.core\paymentgateway\fundtransfer\FundTransferFactory.java", "Java", 61, 0, 6, 67
"d:\eclipseWorkspace4\vmj-payment-gateway\modules\paymentgateway.fundtransfer.core\paymentgateway\fundtransfer\FundTransferResourceFactory.java", "Java", 61, 0, 6, 67
"d:\eclipseWorkspace4\vmj-payment-gateway\modules\paymentgateway.fundtransfer.core\paymentgateway\fundtransfer\core\model\FundTransfer.java", "Java", 31, 0, 3, 34
"d:\eclipseWorkspace4\vmj-payment-gateway\modules\paymentgateway.fundtransfer.core\paymentgateway\fundtransfer\core\model\FundTransferComponent.java", "Java", 51, 0, 9, 60
"d:\eclipseWorkspace4\vmj-payment-gateway\modules\paymentgateway.fundtransfer.core\paymentgateway\fundtransfer\core\model\FundTransferDecorator.java", "Java", 108, 1, 11, 120
"d:\eclipseWorkspace4\vmj-payment-gateway\modules\paymentgateway.fundtransfer.core\paymentgateway\fundtransfer\core\model\FundTransferImpl.java", "Java", 163, 0, 19, 182
"d:\eclipseWorkspace4\vmj-payment-gateway\modules\paymentgateway.fundtransfer.core\paymentgateway\fundtransfer\core\resource\FundTransferResource.java", "Java", 10, 0, 3, 13
"d:\eclipseWorkspace4\vmj-payment-gateway\modules\paymentgateway.fundtransfer.core\paymentgateway\fundtransfer\core\resource\FundTransferResourceComponent.java", "Java", 18, 1, 5, 24
"d:\eclipseWorkspace4\vmj-payment-gateway\modules\paymentgateway.fundtransfer.core\paymentgateway\fundtransfer\core\resource\FundTransferResourceDecorator.java", "Java", 34, 0, 12, 46
"d:\eclipseWorkspace4\vmj-payment-gateway\modules\paymentgateway.fundtransfer.core\paymentgateway\fundtransfer\core\resource\FundTransferResourceImpl.java", "Java", 155, 1, 26, 182
"d:\eclipseWorkspace4\vmj-payment-gateway\modules\paymentgateway.fundtransfer.inbatch\module-info.java", "Java", 13, 1, 3, 17
"d:\eclipseWorkspace4\vmj-payment-gateway\modules\paymentgateway.fundtransfer.inbatch\paymentgateway\fundtransfer\inbatch\resource\InBatchResourceImpl.java", "Java", 71, 0, 15, 86
"d:\eclipseWorkspace4\vmj-payment-gateway\modules\paymentgateway.fundtransfer.infofrombenef\module-info.java", "Java", 10, 1, 3, 14
"d:\eclipseWorkspace4\vmj-payment-gateway\modules\paymentgateway.fundtransfer.infofrombenef\paymentgateway\fundtransfer\infofrombenef\model\InfoFromBenefImpl.java", "Java", 25, 3, 10, 38
"d:\eclipseWorkspace4\vmj-payment-gateway\modules\paymentgateway.fundtransfer.infofrombenef\paymentgateway\fundtransfer\infofrombenef\resource\InfoFromBenefResourceImpl.java", "Java", 59, 10, 16, 85
"d:\eclipseWorkspace4\vmj-payment-gateway\modules\paymentgateway.fundtransfer.scheduled\module-info.java", "Java", 10, 1, 3, 14
"d:\eclipseWorkspace4\vmj-payment-gateway\modules\paymentgateway.fundtransfer.scheduled\paymentgateway\fundtransfer\scheduled\model\ScheduledImpl.java", "Java", 19, 3, 9, 31
"d:\eclipseWorkspace4\vmj-payment-gateway\modules\paymentgateway.fundtransfer.scheduled\paymentgateway\fundtransfer\scheduled\resource\ScheduledResourceImpl.java", "Java", 59, 10, 16, 85
"d:\eclipseWorkspace4\vmj-payment-gateway\modules\paymentgateway.fundtransfer.withapproval\module-info.java", "Java", 10, 1, 3, 14
"d:\eclipseWorkspace4\vmj-payment-gateway\modules\paymentgateway.fundtransfer.withapproval\paymentgateway\fundtransfer\withapproval\model\WithApprovalImpl.java", "Java", 23, 2, 9, 34
"d:\eclipseWorkspace4\vmj-payment-gateway\modules\paymentgateway.fundtransfer.withapproval\paymentgateway\fundtransfer\withapproval\resource\WithApprovalResourceImpl.java", "Java", 57, 9, 15, 81
"d:\eclipseWorkspace4\vmj-payment-gateway\modules\paymentgateway.fundtransfer.withuseraccount\module-info.java", "Java", 13, 1, 3, 17
"d:\eclipseWorkspace4\vmj-payment-gateway\modules\paymentgateway.fundtransfer.withuseraccount\paymentgateway\fundtransfer\withuseraccount\model\WithUserAccountImpl.java", "Java", 43, 0, 11, 54
"d:\eclipseWorkspace4\vmj-payment-gateway\modules\paymentgateway.fundtransfer.withuseraccount\paymentgateway\fundtransfer\withuseraccount\resource\WithUserAccountResourceImpl.java", "Java", 93, 0, 24, 117
"Total", "-", 2952, 86, 716, 3754